%%%%%%%%%%%%%%%%%%%%%%%%%%%%%%
%.                          .%
%                            %
%                            %
%                            %
%                            %
%                            %
%                            %
%                            %
%      P                     %
%                            %
%                            %
%.                          .%
%%%%%%%%%%%%%%%%%%%%%%%%%%%%%%